1111111111111
10010000CC001
10C0011111101
10P0110001E01
1111111111111